1010101013101
0002002000200
0121012121010
2200200200020
1010101010101
0040000200200
0101010101010
0000400000500
