03000000
00000000
00000000
00000050
04000000
04004000
00400000
00000400
