131010101
000000000
010101010
000000005
101010101
